111111111111111111111111111111111111111
100000000010000000000000000000000000001
10000000C010000000000000000000000000001
1000000000100000000000C000000000C000001
100000000010000000000000000001111111111
100000P00010000000000000000000000000001
100000000010011100000000000000000000001
10000000001001C10000CCCCCC0000000000001
100000000000010100000000000000000000001
100000000000010000000011111111111111111
1000C0000000010000000000000000000000001
100000000000010000000000000000000000001
111111111111111111111000000000000000001
100000000000000000000000000000000000001
1000E00000000000000000000000000C0000001
1000000000C0000000000000000000000000001
100000000000000000000011111111111111111
100000001111100000000010000000000000001
10000000000000000000000010000E000000001
111111111111111111111111111111111111111