11111111111111111111
1010C010000000000001
100000000P0000000C01
11111111111111111001
10000001000000000001
1000C001001000000E01
10000000001000000001
11111111111111111111