11111111111111111111
1000C000000000000001
100000000P0000000C01
10000000000000000001
10000000000000000001
1000C000000000000E01
10000000000000000001
11111111111111111111